########################
#..........##..........#
##....................##
#..........##..........#
#..........##..........#
######............######
#......................#
#......##......##......#
#..........##..........#
#..........##..........#
#......................#
#....##############....#
#......................#
########################